p v v v e v v v v p
v w w v w v v w v w
w w v v w w w v v w
w v v v v v w p v p
v p e w p v w v e w